PSSSSSSXSSSSSSSSSSSSSS
SSSSSSXSXXXXSSSSSSSSSS
SSSSXXSSSSSSXSSSSSSSSS
XXXXSSSSSSSSSXSSSSSSSS
XSSSSSSSSSSSSSXSSSSSSS
SXSSSSSSSSSSSXSXSSSSSS
SSXXSSSSSSSSSXSSXSSSSS
SSSSXSSSSSSSSXSSSXSSSS
SSSSSXXSSSSSSXSSSSXSSS
SSSSSSSXSSSSSXSSSSSXSS
SSSSSSSXSSSSXSSSSSSSXS
SSSSSSSSXXXXSSSSSSSSSX
SSSSSSSSSXSSSSSSSSSSSS
SSSSSSSSSXSSSSSSSSSSSS
XXXXXXXXXXSSSSSSSSSSSS
SSSSSSSSSXSSSSSSSSSSSS
SSSSSSSSSXSSSSSSSSSSSS
SSSSSSSSSXSSSSSSSSSSSX
SSSSSSSSSXSSSSSSSSSSXS
SSSSSSSSSXSSSSSSSSSXSS
XXSSSSSSSXSSSSSSSSXSSS
SSXXSSSSSXSSSSSSSXSSSS
SSSSXXSSSXSSSSSSXSSSSS
SSSSSSXXSXSSSSSXSSSSSS
SSSSSSSSXXSSSSXSSSSSSS
SSSSSSSSSSXXSXSSSSSSSS
SSSSSSSSSSSSXSSSSSSSSS
SSSSSSSSSSSXSSSSSSSSSS
SSSSSSSSSSXXSSSSSSSSSS
SSSSSSSSSXSSXSSSSSSSSS
SSSSSSSSXSSSSXXXXXSSSS
SSSSSSSXSSSSSSSSSSXSSS
SSSSSSXSSSSSSSSSSSSXSS
SSSSSSXSSSSSSSSSSSSSXX
SSSSSXXSSSSSSSSSSSSSSS
SSXXXSSSSSSSSSSSSSSSSS
SXSSSSSSSSSSSSSSSSSSSS
XSSSSSSSSSSSSSSSSSSSSS
XSSSSSSSSSSSSSSSSSSSSG